R   1080  700

S ./textures/barrel.xpm

NO ./textures/greystone_w.xpm
SO ./textures/wood.xpm
WE ./textures/redbrick.xpm
EA ./textures/bluestone.xpm

C  55 , 100 , 200

F  50 , 125 , 50  





                            11111111111111111111
                              101 101010000000001   
                               11100020000000111
                                10000000000000001         
                               110000100000000001     
                              1002001 10000000001
                              100000010000001111  
                             101100110011011111
                            10002000000000000001
                           110000000000000000001
                          100000N0000000100100001
                          1001000100010000001011
                           11 1111111 111111 11